% 232222
% 202002
% 202102
% 202202
% 202202
% 202202
% 202202
% 202202
% 200002
% 222222
%-
