% 2322000
% 2022000
% 2002000
% 2002222
% 2000002
% 2201222
% 0222200
%-
